1111111111111111111
1C000000000000000E1
1000000000000010001
1000000000000000001
1000000000000000001
1011111111001001001
1000001110000001001
1000100000000001001
10001000000000010P1
1011000001110000C01
1111111111111111111