1111111111111111111
1E0E0E1000CC00100C1
1000000C00S00010001
1S00S00010000000S01
1C0000000000000C001
1011111111001001001
1000001110000001001
1000100000C00001001
1C00100000000001001
1S0C0000P0000001001
1111111111111111111